111111
1P2111
13C011
144E11
155551
