1111111
1PCVEC1
1CCCC11
1111111