11111111111111
111CC00CCCC111
1PCCCCVC0CEC11
1000000CCCC111
11111111111111