111111111
11C0P00V1
1110EC001
1C0001101
1C11C0C01
111111111