11111111
1100CC11
100P0E01
1C000C11
11111111