111111111111111111
11111111CCCCCP1111
111111110111111111
111111110111111111
11111111C111111111
11111111E111111111
111111111111111111