11111111111111111111111111111111111
100000CCCCC110000CCC0C1111000111111
1111CCCCCP0000000000111CCCCCCCCCCC1
1CCCC0000000E00000000111111111CCCC1
10000000000000000000000000000000001
1CCCCCC11011CCCCCCCCCCCCCCCCCCCCCC1
10000111CC1111111CCCCC1111100000011
11111111111111111111111111111111111