11111111
1CCC0001
1PCEC001
10CCCCC1
11111111