111111111
11C0P0001
1110EC001
1C0001101
1C11C0001
111111111