1111111111
1000000CP1
10000000E1
1111111111
1PCCCECCC1
10000000P1
1E00000CC1
1ECCCCCPC1
1111111111