11111111
10000001
10CCCCC1
10000EC1
10000001
11111111