111111111111111
111100000CCC1C1
1CCCCCCCCCCC1C1
110011100000111
1P0C10000000001
1001C100CCCCCE1
111111111111111