1111111111
1100CPCCC1

1EEEEEEEE1