11111111
1CCCCCC1
10000001
11CCE0P1
1C000CCE
11111111