11111111
1000000
1PCCE001
11111111