1111111111111
100C1P1C00001
1111C10000001
1EC0000000001
1111111111111