111111111111
111P0CC00011
11CC000CCCC1
1E100CCCCCC1
111111111111